P,P,P,P,P,P,P,P,P,P
P,P,P,P,P,P,P,P,P,P
P,P,P,M,P,P,P,P,P,W
M,M,M,M,P,P,P,P,W,W
P,P,P,P,P,P,P,W,W,P
P,P,F,F,P,P,P,W,P,P
P,F,F,F,P,P,P,P,P,P
P,F,F,F,F,P,P,P,P,P
P,P,F,F,P,P,P,P,P,P
P,P,P,P,P,P,P,P,P,P