P,P,P,P,P,P,P,P,P,P
P,P,M,P,P,P,P,P,P,P
M,M,M,P,P,P,P,P,P,W
P,P,P,P,P,W,W,W,W,W
P,F,F,F,P,W,W,W,W,P
F,F,F,F,P,W,W,W,P,P
F,F,F,F,P,P,W,P,P,P
P,F,F,F,F,P,P,P,P,P
P,P,F,F,P,P,P,P,P,P
P,P,P,P,P,P,P,P,P,P